n_ n_ n_ n_ n_ n_ n_ n_ n_ n_ n_ n_ n_ n_ n_ n_ n_ n_ n_ n_ n_ n_ n_ n_ n_ n_ n_ n_
n_ d_ d_ d_ n_ n_ n_ n_ n_ n_ n_ n_ n_ n_ n_ n_ n_ n_ n_ n_ n_ d_ d_ d_ n_ n_ n_ n_
n_ d_ d_ d_ n_ n_ n_ n_ n_ n_ n_ n_ d_ d_ d_ n_ n_ n_ n_ n_ n_ d_ d_ d_ n_ n_ n_ n_
n_ n_ d_ n_ n_ n_ n_ d_ d_ d_ d_ d_ d_ dP d_ n_ n_ n_ n_ n_ n_ d_ d_ d_ n_ n_ n_ n_
n_ n_ d_ n_ n_ n_ n_ d_ n_ n_ n_ n_ d_ d_ d_ n_ n_ n_ n_ n_ n_ n_ d_ n_ n_ n_ n_ n_
n_ n_ d_ d_ d_ d_ d_ d_ n_ n_ n_ n_ n_ n_ n_ n_ n_ n_ n_ n_ n_ n_ d_ n_ n_ n_ n_ n_
n_ n_ d_ n_ n_ n_ n_ n_ n_ n_ n_ n_ n_ n_ n_ n_ n_ n_ n_ n_ n_ n_ d_ n_ n_ n_ n_ n_
n_ n_ d_ n_ n_ n_ n_ n_ n_ n_ n_ n_ n_ n_ n_ n_ n_ n_ n_ d_ d_ d_ d_ d_ d_ d_ n_ n_
n_ n_ d_ n_ n_ n_ n_ n_ n_ n_ n_ d_ d_ d_ d_ d_ n_ n_ n_ d_ d_ d_ d_ d_ d_ d_ n_ n_
n_ n_ d_ d_ d_ d_ d_ d_ n_ n_ n_ d_ d_ d_ d_ d_ n_ n_ n_ d_ d_ d_ d_ d_ d_ d_ n_ n_
n_ n_ n_ d_ n_ n_ n_ d_ n_ n_ n_ d_ d_ d_ d_ d_ n_ n_ n_ d_ d_ d_ d_ d_ d_ d_ n_ n_
n_ n_ n_ d_ n_ n_ n_ d_ n_ n_ n_ n_ n_ d_ n_ n_ n_ n_ n_ n_ n_ n_ d_ n_ n_ n_ n_ n_
n_ n_ d_ d_ d_ n_ n_ d_ n_ n_ n_ n_ n_ d_ n_ n_ n_ n_ n_ n_ n_ n_ d_ n_ n_ n_ n_ n_
n_ n_ d_ d_ d_ n_ n_ d_ n_ n_ n_ n_ n_ d_ n_ n_ n_ n_ n_ n_ d_ d_ d_ d_ d_ n_ n_ n_
n_ n_ d_ d_ d_ n_ n_ d_ n_ n_ n_ n_ n_ d_ n_ n_ n_ n_ n_ n_ d_ n_ n_ n_ d_ n_ n_ n_
n_ n_ n_ n_ n_ n_ n_ d_ d_ d_ d_ d_ d_ d_ d_ d_ d_ d_ d_ d_ d_ n_ n_ n_ d_ n_ n_ n_
n_ n_ n_ n_ n_ n_ n_ d_ n_ n_ n_ n_ n_ n_ n_ n_ n_ n_ n_ n_ d_ n_ n_ n_ d_ n_ n_ n_
n_ n_ n_ n_ n_ n_ n_ d_ n_ n_ n_ n_ n_ n_ n_ n_ n_ n_ n_ n_ d_ n_ n_ n_ d_ n_ n_ n_
n_ n_ d_ d_ d_ n_ n_ d_ n_ n_ d_ d_ d_ n_ n_ n_ n_ n_ d_ d_ d_ d_ n_ n_ d_ n_ n_ n_
n_ n_ d_ d_ d_ d_ d_ d_ d_ d_ d_ d_ d_ n_ n_ n_ n_ n_ d_ d_ d_ d_ n_ n_ d_ n_ n_ n_
n_ n_ d_ d_ d_ n_ n_ d_ n_ n_ d_ d_ d_ n_ n_ n_ n_ n_ d_ d_ d_ d_ n_ n_ d_ n_ n_ n_
n_ n_ n_ n_ n_ n_ n_ d_ n_ n_ n_ n_ n_ n_ n_ n_ n_ n_ n_ n_ n_ n_ n_ n_ d_ n_ n_ n_
n_ n_ n_ n_ n_ n_ n_ d_ n_ n_ n_ n_ n_ n_ d_ d_ d_ d_ d_ d_ d_ d_ d_ d_ d_ n_ n_ n_
n_ n_ n_ n_ n_ n_ d_ d_ d_ d_ n_ n_ n_ n_ d_ n_ n_ n_ n_ n_ n_ n_ n_ n_ n_ n_ n_ n_
n_ n_ n_ n_ n_ n_ d_ d_ d_ d_ n_ n_ n_ n_ d_ n_ n_ n_ n_ n_ n_ n_ n_ n_ n_ n_ n_ n_
n_ n_ n_ n_ n_ n_ d_ d_ d_ d_ n_ n_ d_ d_ d_ d_ d_ n_ n_ n_ n_ n_ n_ n_ n_ n_ n_ n_
n_ n_ n_ n_ n_ n_ n_ n_ n_ n_ n_ n_ d_ d_ dO d_ d_ n_ n_ n_ n_ n_ n_ n_ n_ n_ n_ n_
n_ n_ n_ n_ n_ n_ n_ n_ n_ n_ n_ n_ n_ n_ n_ n_ n_ n_ n_ n_ n_ n_ n_ n_ n_ n_ n_ n_
