f_f_f_f_f_f_f_f_f_f_f_f_f_f_f_m_m_m_m_m_m_m_m_m_m_m_m_m_m_m_m_m_m_m_m_m_m_m_m_m_m_m_
f_g_gSf_g_f_g_f_g_g_g_g_g_g_g_m_m_m_m_m_m_m_s_s_s3s_s_m_m_m_m_m_m_s_s_s_s_m_m_m_m_m_
f_g_g_f_g_g_g_f_g_f_g_g_g_g_g_g_m_m_m_m_m_s_s_s_s_s_s_s_m_m_m_m_s_s_s_s_s_s_m_m_m_m_
f_g_f_f_g_f_g_w_w_w_g_g_g_g_g_g_g_m_s_s_s_s_s_s_s_s_s_s_s_s_s_s_s_s_s_s_s_s_s_s_m_m_
f_g_g_g_g_f_g_w_w_w_g_g_g_g_g_g_g_m_s_g_g_s_g_g_g_g_g_g_g_g_g_m_s_s_s_s_s_s_g_g_m_m_
f_g_f_f_gDf_g_w_g_g_g_g_g_g_g_g_g_m_s_g_g_g_g_g_g_g_g_g_g_g_g_w_g_s_s_s_s_m_w_m_m_m_
f_g_f_f_g_f_g_w_w_w_g_g_g_g_g_g_g_m_s_g_g_g_g_g_g_g_g_g_g_g_g_w_g_g_g_m_m_m_w_g_m_m_
f_g_f_f_f_f_f_w_w_w_g_g_g_g_g_g_g_m_s_g_g_g_g_g_g_g_g_g_g_g_g_w_g_g_g_m_g_g2w_m_g_m_
f_g_g_f_g_f_f_w_w_w_g_g_w_g_g_g_g_m_s_g_g_g_g_g_g_g_g_g_g_g_g_w_g_g_g_m_g_g_w_m_g_m_
f_f_f_f_g_f_f_f_g_g_g_w_w_w_g_g_g_m_s_m_g_g_g_g_g_g_g_g_g_g_g_w_g_g_g_g_m_m_w_g_g_m_
f_g_g_f_g_g_g_g_g_g_w_w_w_w_w_g_g_m_m_m_g_g_g_g_g_g_g_g_g_g_g_w_g_g_g_m_m_m_w_g_g_m_
f_g_g_f_g_m_g_g_g_g_g_w_w_w_g_g_g_g_g_g_g_g_g_g_g_g_g_g_g_g_w_w_w_w_w_w_w_w_w_g_g_m_
f_g_g_f_g_m_g_g_g_g_g_g_w_g_g_g_g_g_g_g_g_g_g_g_g_g_g_g_g_g_w_g_g_g_g_g_g_g_g_g_g_m_
f_g_g_f_g_m_g_m_g_g_g_g_g_g_g_g_g_g_g_g_g_g_g_g_g_g_g_g_g_g_w_g_g_g_g_g_g_g_g_g_g_m_
f_g_g_g_g_m_m_m_g_g_g_g_g_g_g_g_g_g_g_g_g_g_g_g_g_g_g_g_g_g_w_g_g_g_g_g_g_g_g_s2g_m_
f_g_f_f_f_f_f_g_f_f_f_g_g_g_g_g_g_g_g_g_g_g_g_g_g_g_g_g_g_g_w_g_g_g_g_g_g_g_g_g_g_m_
f_g_g_g_f_g_m_m_m_g_g_g_g_g_g_g_g_g_w_w_w_w_w_w_w_w_w_w_g_g_g_g_g_g_g_g_g_g_g_g_m_m_
f_g_g_g_g_g_m_m_m_g_g_g_g_g_g_g_g_g_w_g_g_g_g_g_g_g_g_w_g_g_w_g_g_g_g_g_g_g_g_g_s_m_
f_g_f_g_g_g_m_m_m_g_g_g_g_g_g_g_g_g_w_g_g_g_g_g_g_g_g_w_w_w_w_g_g_g_g_g_g_g_g_g_s_m_
f_g_f_g_g_g_m_m_m_g_g_g_g_g_g_g_g_g_g_g_g_g_g_g_g_g_g_w_g_g_g_g_g_g_g_g_g_g_g_g_m_m_
f_g_f_g_g_g_g_g_g_g_g_g_g_g_g_g_g_g_w_g_g_g_g_g_g_g_g_w_g_g_g_g_g_g_g_g_g_g_g_g_s_m_
f_g_f_g_g_g_g_g_g_g_g_g_g_g_g_g_g_g_w_g_g_g_g_g_g_g_g_g_g_g_g_g_g_g_g_g_g_g_g_g_m_m_
f_g_g_g_g_g_g_g_g_g_g_g_g_g_g_g_g_g_w_g_g_g_g_g_g_g_g_w_g_g_g_g_g_g_g_g_g_g_g_g_s_m_
f_g_g_g_g_g_g_g_g_g_g_g_g_g_g_g_g_g_w_w_w_g_g_w_w_w_w_w_g_g_g_g_g_g_g_g_g_g_g_g_m_m_
f_f_f_f_f_f_f_g_g_g_g_g_g_g_g_g_g_g_g_g_g_g_g_g_g_g_g_w_g_g_g_g_g_g_g_g_g_g_g_g_g_m_
f_f_f_f_f_f_g_g_g_g_g_g_g_g_g_g_g_g_g_g_g_g_g_g_g_g_g_w_g_g_g_g_g_g_g_g_g_g_g_g_g_m_
f_g_f_g_f_g_g_g_g_g_g_g_g_g_g_g_g_g_g_g_g_g_g_g_g_g_g_w_g_g_g_g_g_g_g_g_g_g_g_g_m_m_
m_g_g_g_g_g_g_g_g_g_g_g_g_g_g_g_g_g_g_g_g_g_g_g_gHg_w_g_g_g_g_g_g_g_g_m_g_g_g_g_g_m_
m_g_g_g_g_g_g_g_g_g_g_g_g_g_g_g_g_g_g_g_g_g_g_g_g_g_g_w_g_g_g_g_g_g_g_g_g_g_g_g_g_m_
m_g_g_g_g_g_g_g_g_g_g_g_g_g_g_g_g_g_g_g_g_g_g_g_g_g_g_w_w_w_g_w_w_w_w_g_w_w_g_g_m_m_
m_g_g_g_g_s_s_s_g_g_g_g_g_g_g_g_g_g_g_g_g_g_g_g_g_g_g_g_g_g_g_g_g_g_w_g_w_w_w_g_g_m_
m_m_m_m_m_m_m_m_m_g_g_g_g_m_m_m_m_m_m_m_g_g_m_m_m_m_m_m_g_g_g_g_g_g_w_w_g_g_w_w_g_m_
m_s_s_s_s_s1s_s_m_g_g_g_m_m_g_g_g_g_g_g_g_g_g_g_g_g_g_m_g_g_g_g_g_g_m_m_m_m_m_m_m_m_
m_s_m_m_s_s_s_s_m_g_g_m_m_m_m_g_g_g_g_g_g_g_g_g_g_g_g_m_w_w_w_w_w_w_w_w_m_m_w_w_m_m_
m_s_m_m_s_s_s_s_m_g_g_g_g_g_g_g_g_g_g_g_g_g_g_g_g_g_g_m_w_w_w_w_w_w_w_w_m_m_w_w_m_m_
m_s_s_s_s_s_s_s_m_g_g_m_m_m_m_g_g_g_g_g_g_g_g_g_g_g_g_m_w_w_w_w_m_m_w_w_m_m_w_w_m_m_
m_s_s_s_s_s_s_s_m_g_g_m_m_m_m_g_g_g_g_g_g_g_g_g_g_g_g_m_w_w_w_w_m_m_w_w_m_m_w_w_m_m_
m_s_s_s_s_s_s_m_m_m_g_g_g_g_g_g_g_g_g_g_g_g_g_g_g_g_g_m_w_w_w_w_w_w_w_w_m_m_w_w_m_m_
m_s_s_s_s_s_s_s_s_m_g_g_g_g_g_g_g_g_g_g_g_g_g_g_g_g_g_m_w_w_w_w_w_w_w_w_m_m_w_w_m_m_
m_s_s_s_s_s_s_s_s_m_m_m_g_g_f_g_g_g_g_g_g_f_g_g_g_m_g_m_w_w_w_w_w_w_w_w_w_w_w_w_m_m_
m_s_s_s_s_s_s_s_s_s_g_g_g_g_g_g_g_g_g_g_g_g_g_g_g_m_m_m_w_w_w_w_w_w_w_w_w_w_w_w_m_m_
m_m_m_m_m_m_m_m_m_m_m_m_m_m_m_m_m_m_m_m_m_m_m_m_m_m_m_m_m_m_m_m_m_m_m_m_m_m_m_m_m_m_
