f_ f_ f_ f_ f_ f_ f_ f_ f_ f_ f_ f_ f_ f_ f_ m_ m_ m_ m_ m_ m_ m_ m_ m_ m_ m_ m_ m_ m_ m_ m_ m_ m_ m_ m_ m_ m_ m_ m_ m_ m_ m_
f_ g_ gS f_ g_ f_ g_ f_ g_ g_ g_ g_ g_ g_ g_ m_ m_ m_ m_ m_ m_ m_ s_ s_ s3 s_ s_ m_ m_ m_ m_ m_ m_ s_ s_ s_ s_ m_ m_ m_ m_ m_
f_ g_ g_ f_ g_ g_ g_ f_ g_ f_ g_ g_ g_ g_ g_ g_ m_ m_ m_ m_ m_ s_ s_ s_ s_ s_ s_ s_ m_ m_ m_ m_ s_ s_ s_ s_ s_ d_ m_ m_ m_ m_
f_ g_ f_ f_ g_ f_ g_ w_ w_ w_ g_ g_ g_ g_ g_ g_ g_ m_ s_ s_ s_ s_ s_ s_ s_ s_ s_ s_ s_ s_ s_ s_ s_ s_ s_ s_ s_ s_ s_ s_ m_ m_
f_ g_ g_ g_ g_ f_ g_ w_ w_ w_ g_ g_ g_ g_ g_ g_ g_ m_ s_ g_ g_ s_ g_ g_ g_ g_ g_ g_ g_ g_ g_ m_ s_ s_ s_ s_ s_ s_ g_ g_ m_ m_
f_ g_ f_ f_ gD f_ g_ w_ g_ g_ g_ g_ g_ g_ g_ g_ g_ m_ s_ g_ g_ g_ g_ g_ g_ g_ g_ g_ g_ g_ g_ w_ g_ s_ s_ s_ s_ m_ w_ m_ m_ m_
f_ g_ f_ f_ g_ f_ g_ w_ w_ w_ g_ g_ g_ g_ g_ g_ g_ m_ s_ g_ g_ g_ g_ g_ g_ g_ g_ g_ g_ g_ g_ w_ g_ g_ g_ m_ m_ m_ w_ g_ m_ m_
f_ g_ f_ f_ f_ f_ f_ w_ w_ w_ g_ g_ g_ g_ g_ g_ g_ m_ s_ g_ g_ g_ g_ g_ g_ g_ g_ g_ g_ g_ g_ w_ g_ g_ g_ m_ g_ g2 w_ m_ g_ m_
f_ g_ g_ f_ g_ f_ f_ w_ w_ w_ g_ g_ w_ g_ g_ g_ g_ m_ s_ g_ g_ g_ g_ g_ g_ g_ g_ g_ g_ g_ g_ w_ g_ g_ g_ m_ g_ g_ w_ m_ g_ m_
f_ f_ f_ f_ g_ f_ f_ f_ g_ g_ g_ w_ w_ w_ g_ g_ g_ m_ s_ m_ g_ g_ g_ g_ g_ g_ g_ g_ g_ g_ g_ w_ g_ g_ g_ g_ m_ m_ w_ g_ g_ m_
f_ g_ g_ f_ g_ g_ g_ g_ g_ g_ w_ w_ w_ w_ w_ g_ g_ m_ m_ m_ g_ g_ g_ g_ g_ g_ g_ g_ g_ g_ g_ w_ g_ g_ g_ m_ m_ m_ w_ g_ g_ m_
f_ g_ g_ f_ g_ m_ g_ g_ g_ g_ g_ w_ w_ w_ g_ g_ g_ g_ g_ g_ g_ g_ g_ g_ g_ g_ g_ g_ g_ g_ w_ w_ w_ w_ w_ w_ w_ w_ w_ g_ g_ m_
f_ g_ g_ f_ g_ m_ g_ g_ g_ g_ g_ g_ w_ g_ g_ g_ g_ g_ g_ g_ g_ g_ g_ g_ g_ g_ g_ g_ g_ g_ w_ g_ g_ g_ g_ g_ g_ g_ g_ g_ g_ m_
f_ g_ g_ f_ g_ m_ g_ m_ g_ g_ g_ g_ g_ g_ g_ g_ g_ g_ g_ g_ g_ g_ g_ g_ g_ g_ g_ g_ g_ g_ w_ g_ g_ g_ g_ g_ g_ g_ g_ g_ g_ m_
f_ g_ g_ g_ g_ m_ m_ m_ g_ g_ g_ g_ g_ g_ g_ g_ g_ g_ g_ g_ g_ g_ g_ g_ g_ g_ g_ g_ g_ g_ w_ g_ g_ g_ g_ g_ g_ g_ g_ s2 g_ m_
f_ g_ f_ f_ f_ f_ f_ g_ f_ f_ f_ g_ g_ g_ g_ g_ g_ g_ g_ g_ g_ g_ g_ g_ g_ g_ g_ g_ g_ g_ w_ g_ g_ g_ g_ g_ g_ g_ g_ g_ g_ m_
f_ g_ g_ g_ f_ g_ m_ m_ m_ g_ g_ g_ g_ g_ g_ g_ g_ g_ w_ w_ w_ w_ w_ w_ w_ w_ w_ w_ g_ g_ g_ g_ g_ g_ g_ g_ g_ g_ g_ g_ m_ m_
f_ g_ g_ g_ g_ g_ m_ m_ m_ g_ g_ g_ g_ g_ g_ g_ g_ g_ w_ g_ g_ g_ g_ g_ g_ g_ g_ w_ g_ g_ w_ g_ g_ g_ g_ g_ g_ g_ g_ g_ s_ m_
f_ g_ f_ g_ g_ g_ m_ m_ m_ g_ g_ g_ g_ g_ g_ g_ g_ g_ w_ g_ g_ g_ g_ g_ g_ g_ g_ w_ w_ w_ w_ g_ g_ g_ g_ g_ g_ g_ g_ g_ s_ m_
f_ g_ f_ g_ g_ g_ m_ m_ m_ g_ g_ g_ g_ g_ g_ g_ g_ g_ g_ g_ g_ g_ g_ g_ g_ g_ g_ w_ g_ g_ g_ g_ g_ g_ g_ g_ g_ g_ g_ g_ m_ m_
f_ g_ f_ g_ g_ g_ g_ g_ g_ g_ g_ g_ g_ g_ g_ g_ g_ g_ w_ g_ g_ g_ g_ g_ g_ g_ g_ w_ g_ g_ g_ g_ g_ g_ g_ g_ g_ g_ g_ g_ s_ m_
f_ g_ f_ g_ g_ g_ g_ g_ g_ g_ g_ g_ g_ g_ g_ g_ g_ g_ w_ g_ g_ g_ g_ g_ g_ g_ g_ g_ g_ g_ g_ g_ g_ g_ g_ g_ g_ g_ g_ g_ m_ m_
f_ g_ g_ g_ g_ g_ g_ g_ g_ g_ g_ g_ g_ g_ g_ g_ g_ g_ w_ g_ g_ g_ g_ g_ g_ g_ g_ w_ g_ g_ g_ g_ g_ g_ g_ g_ g_ g_ g_ g_ s_ m_
f_ g_ g_ g_ g_ g_ g_ g_ g_ g_ g_ g_ g_ g_ g_ g_ g_ g_ w_ w_ w_ g_ g_ w_ w_ w_ w_ w_ g_ g_ g_ g_ g_ g_ g_ g_ g_ g_ g_ g_ m_ m_
f_ f_ f_ f_ f_ f_ f_ g_ g_ g_ g_ g_ g_ g_ g_ g_ g_ g_ g_ g_ g_ g_ g_ g_ g_ g_ g_ w_ g_ g_ g_ g_ g_ g_ g_ g_ g_ g_ g_ g_ g_ m_
f_ f_ f_ f_ f_ f_ g_ g_ g_ g_ g_ g_ g_ g_ g_ g_ g_ g_ g_ g_ g_ g_ g_ g_ g_ g_ g_ w_ g_ g_ g_ g_ g_ g_ g_ g_ g_ g_ g_ g_ g_ m_
f_ g_ f_ g_ f_ g_ g_ g_ g_ g_ g_ g_ g_ g_ g_ g_ g_ g_ g_ g_ g_ g_ g_ g_ g_ g_ g_ w_ g_ g_ g_ g_ g_ g_ g_ g_ g_ g_ g_ g_ m_ m_
m_ g_ g_ g_ g_ g_ g_ g_ g_ g_ g_ g_ g_ g_ g_ g_ g_ g_ g_ g_ g_ g_ g_ g_ gH g_ w_ g_ g_ g_ g_ g_ g_ g_ g_ m_ g_ g_ g_ g_ g_ m_
m_ g_ g_ g_ g_ g_ g_ g_ g_ g_ g_ g_ g_ g_ g_ g_ g_ g_ g_ g_ g_ g_ g_ g_ g_ g_ g_ w_ g_ g_ g_ g_ g_ g_ g_ g_ g_ g_ g_ g_ g_ m_
m_ g_ g_ g_ g_ g_ g_ g_ g_ g_ g_ g_ g_ g_ g_ g_ g_ g_ g_ g_ g_ g_ g_ g_ g_ g_ g_ w_ w_ w_ g_ w_ w_ w_ w_ g_ w_ w_ g_ g_ m_ m_
m_ g_ g_ g_ g_ s_ s_ s_ g_ g_ g_ g_ g_ g_ g_ g_ g_ g_ g_ g_ g_ g_ g_ g_ g_ g_ g_ g_ g_ g_ g_ g_ g_ g_ w_ g_ w_ w_ w_ g_ g_ m_
m_ m_ m_ m_ m_ m_ m_ m_ m_ g_ g_ g_ g_ m_ m_ m_ m_ m_ m_ m_ g_ g_ m_ m_ m_ m_ m_ m_ g_ g_ g_ g_ g_ g_ w_ w_ g_ g_ w_ w_ g_ m_
m_ s_ s_ s_ s_ s1 s_ s_ m_ g_ g_ g_ m_ m_ g_ g_ g_ g_ g_ g_ g_ g_ g_ g_ g_ g_ g_ m_ g_ g_ g_ g_ g_ g_ m_ m_ m_ m_ m_ m_ m_ m_
m_ s_ m_ m_ s_ s_ s_ s_ m_ g_ g_ m_ m_ m_ m_ g_ g_ g_ g_ g_ g_ g_ g_ g_ g_ g_ g_ m_ w_ w_ w_ w_ w_ w_ w_ w_ m_ m_ w_ w_ m_ m_
m_ s_ m_ m_ s_ s_ s_ s_ m_ g_ g_ g_ g_ g_ g_ g_ g_ g_ g_ g_ g_ g_ g_ g_ g_ g_ g_ m_ w_ w_ w_ w_ w_ w_ w_ w_ m_ m_ w_ w_ m_ m_
m_ s_ s_ s_ s_ s_ s_ s_ m_ g_ g_ m_ m_ m_ m_ g_ g_ g_ g_ g_ g_ g_ g_ g_ g_ g_ g_ m_ w_ w_ w_ w_ m_ m_ w_ w_ m_ m_ w_ w_ m_ m_
m_ s_ s_ s_ s_ s_ s_ s_ m_ g_ g_ m_ m_ m_ m_ g_ g_ g_ g_ g_ g_ g_ g_ g_ g_ g_ g_ m_ w_ w_ w_ w_ m_ m_ w_ w_ m_ m_ w_ w_ m_ m_
m_ s_ s_ s_ s_ s_ s_ m_ m_ m_ g_ g_ g_ g_ g_ g_ g_ g_ g_ g_ g_ g_ g_ g_ g_ g_ g_ m_ w_ w_ w_ w_ w_ w_ w_ w_ m_ m_ w_ w_ m_ m_
m_ s_ s_ s_ s_ s_ s_ s_ s_ m_ g_ g_ g_ g_ g_ g_ g_ g_ g_ g_ g_ g_ g_ g_ g_ g_ g_ m_ w_ w_ w_ w_ w_ w_ w_ w_ m_ m_ w_ w_ m_ m_
m_ s_ s_ s_ s_ s_ s_ s_ s_ m_ m_ m_ g_ g_ f_ g_ g_ g_ g_ g_ g_ f_ g_ g_ g_ m_ g_ m_ w_ w_ w_ w_ w_ w_ w_ w_ w_ w_ w_ w_ m_ m_
m_ s_ s_ s_ s_ s_ s_ s_ s_ s_ g_ g_ g_ g_ g_ g_ g_ g_ g_ g_ g_ g_ g_ g_ g_ m_ m_ m_ w_ w_ w_ w_ w_ w_ w_ w_ w_ w_ w_ w_ m_ m_
m_ m_ m_ m_ m_ m_ m_ m_ m_ m_ m_ m_ m_ m_ m_ m_ m_ m_ m_ m_ m_ m_ m_ m_ m_ m_ m_ m_ m_ m_ m_ m_ m_ m_ m_ m_ m_ m_ m_ m_ m_ m_
